blance	control
brance	control
crance	control
drance	control
quance	control
sance	control
shance	control
slance	control
snance	control
spance	control
blange	critical
brange	critical
crange	critical
drange	critical
quange	critical
sange	critical
shange	critical
slange	critical
snange	critical
spange	critical
frand	control
nand	control
shand	control
tand	control
yand	control
dant	control
frant	control
nant	control
prant	control
tant	control
dald	critical
frald	critical
nald	critical
shald	critical
tald	critical
yald	critical
fralt	critical
nalt	critical
pralt	critical
talt	critical
spleab	control
yeab	control
cheal	control
preal	control
streal	control
cleam	control
queam	control
squean	control
swean	control
gleap	control
chead	critical
clead	critical
glead	critical
pread	critical
quead	critical
splead	critical
squead	critical
stread	critical
swead	critical
yead	critical
brilt	control
snilt	control
swilt	control
ilt	control
chint	control
crint	control
drint	control
shrint	control
slint	control
smint	control
brild	critical
snild	critical
swild	critical
ild	critical
chind	critical
crind	critical
drind	critical
shrind	critical
slind	critical
smind	critical
brond	control
chond	control
crond	control
jond	control
prond	control
gont	control
nont	control
pont	control
ront	control
sont	control
brold	critical
chold	critical
crold	critical
jold	critical
prold	critical
golt	critical
nolt	critical
polt	critical
rolt	critical
solt	critical
cloom	control
poom	control
proom	control
sloom	control
bloon	control
droon	control
gloon	control
groon	control
ploon	control
troon	control
blook	critical
clook	critical
drook	critical
glook	critical
grook	critical
pook	critical
plook	critical
prook	critical
slook	critical
trook	critical
