ball	HF	INC	HI
bank	HF	CON	HI
beach	HF	CON	HI
beak	LF	INC	HI
beard	LF	INC	HI
bed	HF	CON	HI
blink	LF	CON	LI
block	HF	CON	LI
booth	LF	INC	LI
bowl	LF	INC	HI
box	HF	CON	HI
breath	HF	INC	LI
bribe	LF	CON	LI
bridge	HF	CON	HI
broad	HF	INC	LI
broom	LF	CON	HI
bunch	LF	CON	LI
cage	LF	CON	HI
cake	LF	CON	HI
card	LF	INC	HI
care	HF	INC	LI
cave	LF	INC	HI
chair	HF	CON	HI
chalk	LF	CON	HI
child	HF	INC	HI
choose	HF	INC	LI
church	HF	CON	HI
claw	LF	CON	HI
clean	HF	CON	LI
clown	LF	INC	HI
clue	LF	CON	LI
cost	HF	INC	LI
couch	LF	INC	HI
cross	HF	INC	HI
crow	LF	INC	HI
curse	LF	CON	LI
cut	HF	INC	LI
dance	HF	CON	HI
deal	HF	INC	LI
deep	HF	CON	LI
dime	LF	CON	HI
dog	HF	INC	HI
dull	LF	INC	LI
face	HF	CON	HI
fast	HF	CON	LI
fault	LF	CON	LI
fear	HF	INC	LI
fine	HF	CON	LI
five	HF	INC	HI
floor	HF	INC	HI
flute	LF	CON	HI
foe	LF	INC	LI
food	HF	INC	HI
foot	HF	INC	HI
fork	LF	INC	HI
frail	LF	CON	LI
friend	HF	INC	HI
front	HF	INC	LI
frost	LF	INC	HI
gain	HF	CON	LI
gang	LF	CON	HI
gasp	LF	INC	LI
girl	HF	CON	HI
glass	HF	CON	HI
green	HF	INC	HI
grief	LF	CON	LI
group	HF	INC	LI
gun	HF	CON	HI
halt	LF	CON	LI
harm	LF	INC	LI
harp	LF	INC	HI
haste	LF	INC	LI
head	HF	INC	HI
health	HF	CON	LI
height	LF	INC	LI
hold	HF	CON	LI
home	HF	INC	HI
hope	HF	CON	LI
house	HF	INC	HI
join	HF	CON	LI
judge	HF	CON	HI
key	HF	INC	HI
large	HF	CON	LI
lawn	LF	CON	HI
leaf	LF	INC	HI
lease	LF	INC	LI
lend	LF	CON	LI
less	HF	CON	LI
life	HF	CON	LI
lift	LF	CON	LI
light	HF	CON	HI
lose	HF	INC	LI
loud	LF	CON	LI
math	LF	INC	LI
moth	LF	INC	HI
mouth	HF	CON	HI
move	HF	INC	LI
name	HF	CON	LI
neck	HF	CON	HI
nest	LF	CON	HI
note	HF	CON	HI
paid	HF	INC	LI
pet	LF	CON	HI
phrase	LF	INC	LI
pint	LF	INC	LI
pipe	LF	CON	HI
plan	HF	INC	LI
plant	HF	INC	HI
pledge	LF	CON	LI
pond	LF	CON	HI
pure	HF	CON	LI
push	LF	INC	LI
range	HF	INC	LI
rise	HF	INC	LI
roof	HF	INC	HI
rough	LF	INC	LI
rude	LF	CON	LI
safe	HF	INC	LI
scarce	LF	INC	LI
shark	LF	CON	HI
shield	LF	CON	HI
shop	HF	CON	HI
shot	HF	INC	HI
shout	LF	CON	LI
silk	LF	CON	HI
smart	LF	INC	LI
snap	LF	INC	LI
sound	HF	CON	LI
sour	LF	INC	LI
spice	LF	CON	HI
spoon	LF	CON	HI
stale	LF	CON	LI
street	HF	CON	HI
swamp	LF	INC	HI
sweat	LF	INC	HI
sword	LF	INC	HI
task	HF	CON	LI
text	HF	CON	LI
theft	LF	CON	LI
toast	LF	CON	HI
toll	LF	INC	LI
tomb	LF	INC	HI
trade	HF	INC	LI
trick	LF	CON	LI
trim	LF	CON	LI
trust	HF	CON	LI
verb	LF	CON	LI
war	HF	INC	HI
warm	HF	INC	LI
warn	LF	INC	LI
wash	LF	INC	HI
watch	HF	INC	HI
weed	LF	CON	HI
white	HF	CON	HI
wind	HF	INC	HI
wool	LF	INC	HI
worm	LF	INC	HI
worth	HF	INC	LI
wrong	HF	CON	LI
zone	LF	INC	LI
